15
15
###############
#             #
# ### ## #### #
# #         # #
# # ####### # #
#   #     #   #
# # # ###   # #
# # #     # # #
# #   ### # # #
# # #     #   #
#   ####### # #
# #         # #
# #### ### ## #
#             #
###############
20
